NO ./Textures/eagle.xpm
SO ./Textures/mossy.xpm
WE ./Textures/redbrick.xpm
EA ./Textures/wood.xpm
F 150,150,150
C 255,255,255

1111111111111111111111111111111111111111111111111111111111111111
1E00000000000000000000000000000000000000000000000000000000000001
1111111111111111111111111111111111111111111111111111111111111111
