NO ./Textures/eagle.xpm
SO ./Textures/mossy.xpm
WE ./Textures/redbrick.xpm
EA ./Textures/wood.xpm
F 128,0,0
C 255,165,0

111111111111
100000000001
100000000001
10000S000001
100000000001
11111111111		
