111111111111111111111111111111111111111
1000000000000000000S00110000000C0000001
1000C00001000C00000000100111111000C0001
100000000100001000000100000000010001001
1111111111000010000010000111111111C0111
10P000000010001000010000C000000000B0001
10000000000100010000111100000C000110101
100000C00000100000000000000C00000010001
101000000010000C0000C001000000000000001
1C1000000010000100100000000100000000E01
111111111111111111111111111111111111111
